1 1 1 1 1 1 1 1 1 1 1 1 1 1 1 1 1 1 1 1
1             1           1           1
1 k   1                   1           1
1     1           h       1           1
1     1       1           1           1
1     1       1   1     1 1   p       1
1   1 1 1 1   1 1 1                   1
1             1   1                   1
1     w       1   1 1   1 1 1 1   1 1 1
1                                     1
1                 1                   1
1                 1 1 1               1
1                 1                   1
1           1 1 1 1                   1
1 t   1 1 1 1     1                   1
1                 1           m       1
1                 1                   1
1                 1                   1
1                                     1
1 1 1 1 1 1 1 1 1 1 1 1 1 1 1 1 1 1 1 1