1 1 1 1 1 1 1 1 1 1
1                 1
1   a             1
1       1   d     1
1       1         1
1     1 1 1 1     1
1     c     b     1
1                 1
1                 1
1 1 1 1 1 1 1 1 1 1